....................#.....#..........................#.#...#.........#.....#......#..#....#...#.#..#.
.#.....#....#.#...........#.............##.#.......#............#...........#.#......................
...#...........#....#.......#...#....#.......#.......................#.#.....#.#.........#......##.#.
..........##.#.#.............#..##.......#..#............#..#......#...............#.#.#..#....#.....
............#..........#.........................##........#.......#........................#....#...
.....#.................................##....#.......##..#......#.....#...........#........#...##....
.......#.................##...............#......................#..##...#.#......#...........#......
.#..#...#...#..#..............#.#.....#........#..#..#.....#...#...............#.....................
....#...#...#......#...........##............#.....#......#.#.#....#.............#....#....#........#
#.......................................#...............#......##....#...#......#....................
.........#.#...#.......................................#..#....#...#.....#.............#...##...##..#
......#..#.#....#..........#........#.#....#...#..#.....#...##.........#.#........................#..
....#............#....#.....#................#......#.#...............#.....###......#...#...........
.....#.......#................#........#....................####........##..........#...#.....#.....#
.................................#...#.....##.#.#.........#.#...#......................#...#.........
...#................#........#...#.........#...#...#..#........#............#...........#....#....#..
.......................#....##..#.....#..#..#....#......#.#....#......#.#..........#...........#.#.#.
........#......#.#.............#.......#...#..............................#.#...............#........
........#.#.##.........##....##.#..............#....#.....#.......#.......#..................#..#....
.#..#....#.#.......#..#........#.#..........#.#.....#.......#....#...##..........#..#....#...........
.......#.........#....#..................#....#.#.......#..#...........##..#..............#.#..##....
.#.......#...............#..................#....##..#...........#....#...##..................####...
...##..................#........#....#...#.....................#.....................................
...##..............#................#.............#.#..##.#...........................#.........#..#.
#............#........#..#......#................##......#..#.....#.................#..#.....#.......
................#..................#........#.............#.##..............#....#..........#.....#..
............#.........................................#.#.#...#.#....#..................#............
..........#.#......................#...#.....#.........#.#..................#.......#............#..#
.......#...#..#..............#..#...............#...#.#.....#..#.............#....#.......#.#...#....
......#...#.......#.....#.....#.............#......##...........#...#.##.#..#....#.............#..#.#
....#.......#..........#.......................#..............#...#..#..#...##.......................
..#.#........#..#..........#................#......#.........#........#....#.........#.#..#...#......
...............................#..#..#...#....#......#.#...........#...#....#..#.............#.#.#...
.#..........#........#..####.#.....#..#..........#....#....#....#.....#........#.#..#.#.........#.#.#
.#...#...........#............#..#......#........##.....##..........#......#......#.......#....#.....
....#.......#.#.............#...#..#...#......#.....#.......#..........#...........#..#....#......#..
.........#...#.#....#..#.##.............#....#..............#....#.....##..#.#............##.#...#...
.#......#.............#.......#.......#...#.......##..#................#..........#......#....#......
..#.......#....................#.............#..#...#............###........#...#............#..#....
.....#....#..#.##...#..............#........#.#............##........#...#...#.............#..#......
......#..........#..................#.......#........#...#.........#.#...........#....#..#...#......#
...#....................#..##............#.......#.............................#...............#.#...
............#...............................#..#....#....#.#.............................#...#..#....
.........#............#.........##......##.....#.#...#.#..................................#......#...
..#......#..#...#....#.........................#....#.........#..........#.......#............###....
#.................................................#........................#.##.....#..#....#........
.#..........#...#...#...#.#.#...........#..##.........#...........#..#.#.............#...............
.............#...................#.#....#.#........#.#..................#............................
.#..#..........#....#.........#...............##............................#.......#.....##.........
#..##............#....#..#......#..##.................#.#...........#......#..#....#.................
..#..............#..........#..................#..............#..........#..#....#...................
............#...........#......##..#.................#..................#.#...#.#...........#.....#..
...#......##........#..#.#.#.........#......#..#.......#......#..................#...............#...
.............#.......#.....#.#......#...#...........##..#.#.#...#........#.....#..#........#..#......
.........#.#.........#..#..#............##............#...........#...#...#................#..##...#.
..................#.......#.#.#.#.............#.........#.###..........###..........#................
.#..#....#...#....#..#.................#.#........#..##................#.......#..................#..
.........#.............#...................#................#....#..#............#..........#...##...
..............#...#....#.#......#..................#..#..#.....#..........#........#.......#..#...#.#
..#..#...#.#...#...............#............#.............#.#...#......#...#......##....#.......#....
......#......#.#..........................#............#.........#...#..#...........#.............#..
.#.#........#......#..................##........##...#..#.......#..................#.#.#.........#..#
.....#................#...................#..#......................#.......#..#........#.#...#.#....
...........#.#.#.....#.#..#.....#.......#.#..#.#.......#.......#.....#................#..........#..#
...................#................#.........##..#.#...#...............##..#..#........#.#..#.#.....
....#.#..#...#...............#...........#.............#.........................##........#.#.......
.........................#.................#..##......#.....#...........................#...#......#.
.#...#.........##..#..#..#...........#...#....#.#........#..............#..............#.....#.......
....#.............#..#......##........#.....#...............#.................#.....#...#...#...#....
..#..............#.............................##.....#......#................#...........#....#.....
.#.......#.........#.#..........#............................#...................#.....#...........#.
#..#.#......#..#.#.......#...#...........#.....#............#....#..#......#......##.......##.#.....#
.#................##...............#.............#...#..#.#..##.......#.....#...#........#...........
...#.........#........#......#.........##....##.....#.......#....##..#.........#.....#...............
.#.....#............#......#........##.................#.........#..........#.#.........#.......#....
.......#.....#.............##.#.............#........#.......#..#..................#.#...............
#..........#...#.#........#.#.................#...#.#.........#...#...........##..............#......
.................#.............#........#....#.##.#.....#...............#.#.##.....##.....#....#.....
......#.#.....................#........#..##...#...............#...#.#.#..#.............#.#....#.#...
...........#.#.......#..#.........#........#.....#.#.......#...####..##.#....#.....#.....#...........
.........##..#..#.....#........#.........#.#.##............#.....#..........................#........
.##....##............#........#.#...#...#.......##...#...#.#...................##..#.............##..
.........#..........#...#.#..............#...................................#........#.........#..#.
.#......#..#.......#...........##.#...##...........#..............#...........#..#...#.........#..#..
.#............#.#.....#.#.........#.........#.......#.....#.#.................#.........#..#.....#...
.....#...........#.........##.............................#.....#....#........#..........#......#....
#..................#..#....#..##........#..........#.....#.........#...........#.......#...........#.
.........#....#.............#.#.......#......#..........#.#.#....##.....#.#.#......#.......#.........
#.#...#...................##.......#.#..#..#.....#.#.............#...#.......#....#...#...........#..
...#.#...#.........................#................#.#...........#.........#.................#......
...##..................#....#.................##..#..#......................#....#...#....#..........
....................#.....#..............................#.........................#........#........
#...#....###..........#....#..............#.......#.#..#......#................#..#.#....#.......#.#.
.#....#................#.....#.......#.#....#.....#........#.#..#......#...#.#.....#.#...............
#............#..............#.............................................#.....#.......#......#.....
.............#.......#.#..##.............#......#..........#.#...##...#..#..#...#....................
...#...#.............#.#..#...........#.##...#.........#.....##.#..............................#...#.
.#..#.......#...............#...#.....................................#.............##..........#....
.........#...#.#....#..........#................##.#...#......#......#....#.#...#..#..........##...#.
.#........##.............#..#.....##................#..#..#.......#......................#...........
........#.............##.......#.#.....#.........#.......#...#....#.....#...###......#..........#....
